D   Tnsy    FPC
0   D0  ->  2
1   D1  ->  4
2   D2  ->  6
3   D3  ->  8
4   D4  ->  10
5   D5  ->  12
6   D6  ->  14
7   D7  ->  16
8   E0  ->  18
9   E1  ->  20
10  C0  ->  22
11  C1  ->  24
12  C2  ->  26
14  C4  ->  23
15  C5  ->  21
16  C6  ->  19
17  C7  ->  17
18  E6  ->  15
19  E7  ->  13
20  B0  ->  11
21  B1  ->  7
22  B2  ->  3
23  B3  ->  1
24  B4  ->  5
25  B5  ->  9
26  B6  ->  25
